{
  "df_target_to_id": {
    "%F574": 0,
    "%F577": 1,
    "%F575": 2,
    "%F580": 3,
    "%F773": 4,
    "%F776": 5,
    "%F821": 6,
    "%F770": 7,
    "%F872": 8
  }
}